01111111111111111111111111111111111111111111111111
00000000111111111111111111111111111111111111111111
11111110111111110000011111111111111111111111111111
11111110111111110111011111111111111111111111111111
11111110111111110111011111111111111111111111111111
11111110000000000111011111111110000001111111111111
11111111111111111111011111111110111101111111111111
11111111111111111111011111111110111101111111111111
11111111111111111111011111111110111101111111111111
11111111111111111111011111111110111101111111111111
11111111111111111111000000010000111101111111111111
11111111111111111111111111111111111101111111111111
11111111111000000000000000000000000001111111111111
11111111111011111111111111111111111111111111111111
11111111111000011111111111111111111111111111111111
11111111111111011111111111111111111111111111111111
11111111111000011111111111111111111111111111111111
11111111111011111111111111111111111111111111111111
11111111111000000000000000000000000000111111111111
11111111111111111111111111111111111110000000000000
